11111111111111
10000000000001
10000000000001
10000001000001
10000000000001
100000000000N1
11111111111111

WE ./d_img/Wall_1.xpm
EA ./d_img/Wall_1.xpm
NO ./d_img/Wall_1.xpm
SO ./d_img/Wall_1.xpm

F 220,210,185
C 196,156,63
