WE ./d_img/Wall_1.xpm
EA ./d_img/Wall_1.xpm
NO ./d_img/Wall_1.xpm
SO ./d_img/Wall_1.xpm

F 220,210,185
C 196,156,63

11111111111111
10000000000001
10000000000001
10000001000001
10000000000Z01
10000000000001
11111111111111
