NO ./d_img/north.xpm
SO ./d_img/south.xpm
WE ./d_img/weast.xpm
EA ./d_img/east.xpm

F 220,30,0

C 225,30,0

1111111111
1000N00001
1001111001
1101000011
1000011111
1111111111
