NO ./d_img/north.xpm
SO ./d_img/south.xpm
WE ./d_img/weast.xpm
EA ./d_img/east.xpm

F 00000000005

C 225,30,0

1111111111111111111111111
1000000000110000000000001
1011000001110000000000001
100100000000000000000000111111111
111111111011000001110000000000001
100000000011000001110111111111111
1111011111111101000000100011
1111011111111111101012010001
110000001101010111000000100011
10000000000000001100000000001
10000000000000001101010010001
1100000111010101111101111S00111
11110111 1110101 101111010001
11111111 1111111 111111111111
