NO ./path_to_the_north_texture
SO ./path_to_the_south_texture
WE ./path_to_the_west_texture
EA ./path_to_the_east_texture

F 220,100,0
C 225,30,0

        1111111111111111111111111
        1000000000110000000000001
        1011000001110000000000001
111111111011000001110000000000001
100100000000000000000             1
100000000011000001110111111111111
1111011111111101110000001000    1
111101111  111110111010100100001         
110000001101010111000000100            01
10000000000000001100000010001              
10000000000000001101010010001
1000001110101011111011110S0111
11110111 1110101 101111010001
111111111111111 1111111111111
